12 34
**********************************
*                                *
******************************** *
******************************** *
*                                *
* ********************************
* ********************************
*                                *
******************************** *
******************************** *
*  A                             *
**********************************